+--+--+--+--+--+
|              |
+  +  +--+--+  +
|  |     |     *
+  +--+  +--+--+
|     |     |  *
+  *  +  +     +
|     |  |     *
+  +--+  +  +**+
|        |     g 
+--+--+--+--+**+
